1111111111111111111111111111111111
100000000011100C00000C000000000001
10100101001E1000101001000000010101
1010010010111010001001000000010101
1P0000000C00C0000000000000000000C1
1111111111111111111111111111111111